SSSSSSSSSSSS
SSSSSSSSSSSS
SSSSSSSSSSSS
LLLLLLLLLLLL
DDDDDDDDDDDD
RRRRRDDDDRRR
FGDDDDDDDEER
FEEERRRDERER
RDEERRDDERGR
GGEERRDEEDGR
GEEERGDEEERF
RREEDRDREDRD
RTREDRDDDDDD
RDDRDEEEEDER
RRDDDRRRREER
