SSSSSSSSSSSS
SSSSSSSSSSSS
SSSSSSSSSSSS
LLLLLLLLLLLL
RDDDDDDDEEEE
RRRRERDREREE
DDDDGDDDEEEE
DEEERRRDGREE
RDERERDDEEEE
DGEEREDEEREE
EEEREGDREERG
EEEEDRDERGED
ETDEDREDDDDD
EEDREEEEEEEE
EEEDDEEEEEEE