SSSSSSSSSSSS
SSSSSSSSSSSS
SSSSSSSSSSSS
LLLLLLLLLLLL
DDDDDDDDDDDD
RRRRRDRRRRRR
GGDDDDDDDDDD
GEEEDDDDEEED
DEEERRRDEEEG
DEEERTRDEEEG
DEEERDRDDDDF
DEEERDRDDDDD
DRRRRDRDEEEE
FFFFRDGDEEEE
FFFFRRREEEEE
