SSSSSSSSSSSS
SSSSSSSSSSSS
SSSSSSSSSSSS
LLLLLLLLLLLL
RDDDDDDDDDDD
RRRRERDREREE
FDDDGDDDEEEE
DEEERRRDGREE
RDERERDFEEEE
DGEEREDEEREE
EEEREGDREERG
EEEEDRDERGED
ETDEDREDDDDD
EEDREEEEEEEE
EEEDDEEEEEEE
