SSSSSSSSSSSS
SSSSSSSSSSSS
SSSSSSSSSSSS
LLLLLLLLLLLL
DDDDDDDDDDDD
RRRRRDDDDRRR
FGDDDDDDDEER
FEEERRRDERER
RDEERRDDERGR
GGEERRDEEDGR
GEEERGDEEERF
RREEDRDRRRRD
RPREDRDDDDDD
RDDRDEEEEDER
RRDDDRRRREER
